 22 23 24 21 22 23 24 21 21 21 21 21 21 21 21 21 21 21 21 21 21 21 21 25
 21 20 20 20 20 20 20 20 20 20 20 20 20 20 20 20 20 20 20 20 20 20 21 26
 21 20 20 20 20 20 20 20 20 20 20 20 20 20 20 20 20 20 20 20 20 20 20 27
 21 20 20 20 20 20 20 20 20 20 20 20 20 20 20 81 82 83 20 20 20 20 20 21
 21 20 20 20 20 20 20 20 20 20 20 20 20 20 30 84 85 86 20 20 20 20 20 21
 21 20 20 20 20 20 20 20 20 20 20 20 20 31 32 87 88 89 20 20 20 20 20 21
 21 20 20 20 20 20 20 20 20 20 20 20 20 20 34 20 20 20 20 20 20 20 20 21
 21 20 20 20 20 20 20 21 20 20 21 20 20 20 20 20 20 20 20 20 20 20 20 25
 25 20 20 20 20 20 20 20 20 20 25 20 20 20 20 20 20 20 20 20 20 20 20 26
 26 20 20 20 20 20 20 20 20 20 26 20 20 20 20 20 20 20 20 20 20 20 20 27
 27 20 20 20 20 20 20 20 20 21 27 20 20 20 20 20 20 20 20 20 20 20 20 21
 25 20 20 20 20 20 20 20 20 20 21 20 20 20 20 20 20 20 20 20 20 20 20 21
 26 20 20 20 20 20 20 20 20 20 20 20 20 20 20 20 20 20 20 20 21 22 23 24
 27 20 20 20 20 20 20 21 20 20 20 20 20 20 20 20 20 20 20 20 20 20 21 25
 21 20 20 20 20 20 20 20 20 20 20 20 20 20 20 20 20 20 20 20 20 20 20 26
 25 20 20 20 20 20 20 20 20 20 20 20 30 20 20 20 20 20 20 20 20 20 20 27
 26 20 20 20 20 20 20 20 20 20 20 31 32 33 20 20 20 20 20 20 20 20 20 21
 27 20 20 20 20 20 20 20 20 20 20 31 32 33 20 20 20 20 20 20 20 20 20 21
 21 20 20 20 20 20 20 20 20 20 20 20 34 20 20 20 20 20 20 20 20 20 20 21
 21 20 20 20 20 20 20 20 20 20 20 20 20 20 20 20 20 20 20 20 20 20 20 21
 21 20 20 20 20 20 20 20 20 20 20 20 20 20 20 20 20 20 20 20 20 20 20 21
 21 20 20 20 20 20 20 20 20 20 20 20 20 20 20 20 20 20 20 20 20 20 20 25
 21 20 20 20 91 92 93 20 20 20 20 20 20 20 20 20 20 91 92 93 20 20 20 26
 22 23 24 21 94 95 96 21 22 23 24 21 21 21 21 21 21 94 95 96 21 21 21 27