 65 61 62 62 62 62 62 62 62 62 62 94 95 96 62 62 62 62 62 62 62 62 62 63
 65 64 60 60 60 60 60 60 60 60 60 97 98 99 60 60 60 60 60 60 60 60 60 66
 61 72 60 60 60 60 60 60 60 60 60 60 60 60 60 60 60 60 60 60 60 60 60 66
 64 60 60 60 60 60 74 75 75 75 76 60 60 60 60 60 60 60 60 60 60 60 60 66
 64 60 60 60 60 60 77 78 78 78 79 60 60 60 74 76 60 74 76 60 60 60 60 66
 64 60 60 60 60 60 60 60 60 60 60 60 60 60 77 79 60 77 79 60 60 60 60 66
 64 60 60 60 60 60 60 60 60 60 60 60 60 60 60 60 60 60 60 60 60 60 60 66
 64 60 60 60 60 60 60 60 60 60 60 60 60 60 60 60 60 70 68 68 68 68 68 69
 67 68 68 68 68 68 71 60 60 60 60 60 60 60 60 60 60 66 65 65 65 65 65 65
 65 65 65 65 65 65 67 68 68 68 68 71 60 60 60 60 60 66 65 65 65 65 65 65
 65 65 65 65 65 65 65 65 65 65 65 64 60 60 60 60 60 66 65 65 65 65 65 65
 65 65 65 65 65 65 65 65 65 65 65 67 68 68 68 68 68 69 65 65 65 65 65 65
 65 65 65 65 65 65 65 65 65 65 65 65 65 65 65 65 65 65 65 65 65 65 65 65
 65 65 65 65 65 65 65 65 65 65 65 65 65 65 65 65 65 65 65 65 65 65 65 65
 65 65 61 62 62 62 63 65 65 65 65 65 65 65 65 65 65 65 65 65 65 65 65 65
 65 65 64 60 60 60 73 62 62 62 62 63 65 65 65 65 65 65 65 65 65 65 65 65
 61 62 72 60 60 60 60 60 60 60 60 66 65 65 65 65 65 65 65 65 61 63 65 65
 64 60 60 60 60 60 60 60 60 60 60 66 65 65 65 65 65 65 65 65 64 66 65 65
 64 60 60 60 60 60 60 60 60 60 60 73 62 62 62 63 65 65 65 65 67 69 65 65
 64 60 60 60 60 60 60 60 60 60 60 60 60 60 60 66 65 65 65 65 65 65 65 65
 64 60 60 60 60 60 60 60 60 60 60 60 60 60 60 66 65 65 65 65 65 65 65 65
 64 60 60 60 60 60 60 60 60 60 60 60 60 60 70 69 65 65 65 65 65 65 65 65
 64 60 91 92 93 60 60 60 60 60 60 60 60 60 66 65 65 65 65 65 65 65 65 65
 67 68 94 95 96 68 68 68 68 68 68 68 68 68 69 65 65 65 65 65 65 65 65 65