 21 21 21 21 21 21 21 21 21 21 21 94 95 96 21 25 21 21 21 21 21 21 21 21
 21 20 20 20 20 20 20 20 20 20 20 97 98 99 20 26 20 20 20 20 20 20 20 21
 21 20 20 20 20 20 20 20 20 20 20 20 20 20 20 27 25 20 20 20 20 20 20 21
 21 20 20 20 20 20 20 20 20 20 20 20 20 20 20 20 26 20 20 20 20 20 20 21
 21 20 20 20 81 82 83 20 20 20 20 20 20 20 20 20 27 20 20 20 20 20 20 21
 21 20 20 20 84 85 86 20 20 20 20 20 20 20 20 20 21 20 20 20 20 20 20 21
 21 20 20 20 87 88 89 20 20 20 20 20 20 22 23 24 20 20 20 20 20 20 20 21
 21 20 20 20 20 20 20 20 20 20 20 20 22 23 24 20 20 20 20 20 20 20 91 92
 21 20 20 20 20 20 20 20 20 20 20 20 20 21 20 20 20 20 20 20 20 20 94 95
 21 20 20 20 20 20 22 23 24 20 22 23 24 20 20 20 20 20 20 20 20 20 97 98
 24 20 20 20 20 22 23 24 20 21 20 20 20 20 20 20 20 20 20 20 20 20 20 21
 25 20 20 22 23 24 20 20 20 20 20 20 20 20 20 20 20 20 20 20 20 20 20 21
 26 20 20 21 20 20 20 20 20 20 20 20 20 20 20 20 20 20 20 20 20 20 20 21
 27 21 22 23 20 20 20 20 20 20 20 20 20 20 20 20 20 20 20 20 20 20 20 21
 21 22 23 20 20 20 20 20 20 20 20 20 20 20 20 20 20 20 20 20 20 20 20 21
 92 93 20 20 20 20 20 20 20 20 20 20 20 20 20 20 20 20 20 20 20 20 20 21
 95 96 20 20 20 20 20 20 20 20 20 20 20 20 20 20 20 20 20 20 20 20 20 21
 98 99 20 20 20 20 20 30 20 20 20 20 20 20 20 20 20 20 20 20 20 20 20 21
 21 20 20 20 20 20 31 32 33 20 20 20 20 20 20 20 20 20 20 20 20 20 20 21
 21 20 20 20 20 20 31 32 33 20 20 20 20 20 20 20 20 20 20 20 20 20 20 21
 21 20 20 20 20 20 31 32 33 20 20 20 20 20 20 20 20 20 20 20 20 20 20 21
 21 20 20 20 20 20 20 34 20 20 20 20 20 20 20 20 20 20 20 20 20 20 20 21
 21 20 20 20 20 20 20 20 20 20 20 91 92 93 20 20 20 20 20 20 20 20 21 21
 21 21 21 21 21 21 21 21 21 21 21 94 95 96 21 21 21 21 21 21 21 21 21 20