 65 61 62 62 62 62 62 62 62 62 62 62 62 62 62 62 62 62 63 65 94 95 96 65
 92 93 60 60 60 60 60 60 60 60 60 60 60 60 60 60 60 60 66 61 97 98 99 63
 95 96 60 60 60 60 60 60 60 60 60 60 60 60 60 60 60 60 66 64 74 75 76 66
 98 99 60 60 60 60 60 60 60 60 60 60 60 60 60 60 60 60 66 64 77 78 79 66
 65 67 68 68 68 68 68 68 68 68 68 68 68 68 71 60 60 60 66 64 60 60 60 66
 61 62 62 62 62 62 62 62 62 62 62 62 62 63 64 60 60 60 66 64 60 60 60 66
 64 60 60 60 60 60 60 60 60 60 60 60 60 66 64 60 60 60 66 64 60 60 60 66
 64 60 60 60 60 60 60 60 60 60 60 60 60 66 64 60 60 60 66 64 60 60 60 66
 64 60 60 60 60 60 60 60 60 60 60 60 60 66 64 60 60 60 66 64 60 60 60 66
 64 60 60 60 70 68 68 68 68 71 60 60 60 73 72 60 60 60 66 64 60 60 60 66
 64 60 60 60 66 61 62 62 62 72 60 60 60 60 60 60 60 60 66 64 60 60 60 66
 64 60 60 60 66 64 60 74 75 75 75 75 75 75 75 75 76 60 66 64 60 60 60 66
 64 60 60 60 66 64 60 77 78 78 78 78 78 78 78 78 79 60 66 64 60 60 60 66
 64 60 60 60 66 64 60 60 60 60 60 60 60 60 70 68 68 68 69 64 60 60 60 66
 64 60 60 60 66 64 60 60 60 70 71 60 60 60 73 62 62 62 62 72 60 60 60 66
 64 60 60 60 66 64 60 60 60 66 64 60 60 60 60 60 60 60 60 60 60 60 60 66
 64 60 60 60 66 64 60 60 60 66 64 60 60 60 60 60 60 60 60 60 60 60 60 66
 64 60 60 60 66 64 60 60 60 66 64 60 60 60 60 60 60 60 60 60 60 60 60 66
 64 60 60 60 66 64 60 60 60 66 67 68 68 68 68 68 68 68 68 68 68 68 68 69
 64 60 60 60 66 64 60 60 60 73 62 62 62 62 62 62 62 62 62 62 62 62 63 65
 64 74 75 76 66 64 60 60 60 60 60 60 60 60 60 60 60 60 60 60 60 60 91 92
 64 77 78 79 66 64 60 60 60 60 60 60 60 60 60 60 60 60 60 60 60 60 94 95
 67 91 92 93 69 64 60 60 60 60 60 60 60 60 60 60 60 60 60 60 60 60 97 98
 65 94 95 96 65 67 68 68 68 68 68 68 68 68 68 68 68 68 68 68 68 68 69 65