 00 00 00 01 01 01 01 01 01 01 01 01 01 01 01 01 94 95 96 01 01 00 00 00
 00 00 00 00 00 00 00 00 00 00 00 00 00 00 00 00 97 98 99 00 00 00 00 00
 00 00 00 10 00 00 00 00 00 00 00 00 00 00 00 00 00 00 00 00 00 00 00 00
 01 00 11 12 13 00 00 00 00 00 00 00 00 00 00 00 00 00 00 00 00 00 00 01
 01 00 00 14 00 00 00 00 00 00 00 00 00 00 00 00 00 00 00 00 00 00 00 01
 01 00 00 00 00 00 00 00 00 00 00 00 00 00 00 00 00 00 00 00 00 00 00 01
 01 00 00 00 00 00 00 00 00 00 00 00 00 00 00 00 02 03 01 01 01 01 01 01
 01 00 00 00 00 00 00 00 00 00 00 00 00 00 00 01 04 05 01 00 00 00 00 01
 01 00 00 00 00 00 00 00 00 00 00 00 00 00 00 00 00 00 00 00 00 00 00 01
 01 00 00 00 00 00 00 10 00 00 00 00 00 00 00 00 00 00 00 00 00 00 00 01
 01 00 00 00 00 00 11 12 13 00 00 00 00 00 00 00 00 00 00 00 00 00 00 01
 01 00 00 00 00 00 11 12 13 00 00 00 00 00 00 00 00 00 00 00 00 00 91 92
 01 00 00 00 00 00 00 14 00 00 00 00 00 00 00 00 01 00 00 00 00 00 94 95
 01 00 00 00 00 00 00 00 00 00 00 00 00 00 00 00 00 00 00 00 00 00 97 98
 01 00 00 00 00 00 00 00 00 00 00 00 00 00 00 00 00 00 00 00 00 00 00 01
 01 00 00 00 00 00 00 00 00 00 00 00 00 00 00 00 00 00 00 00 00 00 00 01
 01 00 00 00 00 00 00 00 00 00 00 00 00 00 00 00 00 00 00 00 00 00 00 01
 02 03 01 01 01 01 01 00 00 00 00 00 00 00 00 00 00 00 00 00 00 00 00 01
 04 05 02 03 00 00 00 00 00 00 00 00 00 00 00 00 00 00 00 00 00 00 00 01
 02 03 04 05 00 00 00 00 00 00 00 00 00 00 00 00 00 00 00 00 00 00 00 01
 04 05 00 00 00 00 00 00 00 00 00 00 00 00 00 00 00 00 00 00 00 00 00 01
 00 00 00 00 00 00 00 00 00 00 00 00 00 00 00 00 00 00 00 00 00 00 00 00
 00 00 00 00 00 01 00 00 00 00 00 00 00 00 00 00 00 00 00 00 00 00 00 00
 00 00 00 00 01 01 01 01 01 01 01 01 01 01 01 01 01 01 01 01 01 00 00 00