 01 94 95 96 02 03 02 03 94 95 96 01 94 95 96 01 01 01 01 94 95 96 01 01
 01 97 98 99 04 05 04 05 97 98 99 00 97 98 99 00 00 00 00 97 98 99 00 01
 01 00 00 00 00 02 03 00 00 00 00 00 00 00 00 00 00 00 00 00 00 00 00 01
 01 00 00 00 00 04 05 00 00 00 00 00 00 00 00 00 00 00 00 00 00 00 00 01
 01 00 00 15 16 00 01 00 00 00 00 11 12 00 00 00 00 00 00 00 00 00 00 01
 01 00 00 00 15 16 00 01 00 00 00 00 00 00 00 00 00 00 00 00 00 00 00 01
 01 00 00 00 00 00 00 00 01 00 00 00 00 00 00 00 02 03 01 00 00 00 02 03
 01 00 00 00 00 00 00 00 00 00 00 00 00 00 00 01 04 05 00 00 00 00 04 05
 01 00 00 00 00 00 00 00 00 00 00 00 00 00 01 00 00 00 00 00 00 00 00 01
 01 00 00 00 00 00 00 00 00 00 00 00 01 01 00 00 00 00 00 00 00 00 00 01
 01 00 00 00 00 00 00 00 01 01 00 00 00 00 00 00 00 00 00 00 00 00 00 01
 01 00 00 00 00 00 00 01 00 00 00 00 00 00 00 00 00 00 00 00 00 00 00 01
 01 00 00 00 00 00 00 00 00 00 00 00 00 00 00 00 00 00 00 00 00 00 00 01
 01 00 00 00 00 00 10 00 00 00 00 00 00 00 00 00 00 00 00 00 00 00 00 01
 01 00 00 00 00 00 00 00 00 00 00 00 00 00 00 00 00 00 00 00 00 01 01 01
 01 00 00 00 00 00 00 00 00 00 00 00 00 00 00 00 00 00 00 00 00 00 00 01
 01 00 00 00 00 00 00 00 00 00 00 00 00 00 00 00 00 00 00 00 00 00 00 01
 01 00 00 00 00 00 00 00 00 00 00 00 00 00 00 00 00 00 00 00 00 00 00 01
 01 00 00 00 00 00 00 00 00 00 00 00 00 00 00 00 00 00 00 00 00 00 00 01
 01 00 00 00 00 00 00 00 00 00 00 00 00 00 00 00 00 11 12 00 00 00 00 01
 01 00 00 01 00 00 00 00 00 00 00 00 00 00 00 00 00 00 13 14 00 00 00 01
 01 00 10 00 00 00 00 00 00 00 02 03 00 00 00 00 00 00 00 00 00 00 00 01
 01 00 00 00 00 00 00 00 00 00 04 50 00 00 00 00 00 00 00 00 00 00 02 03
 01 01 01 01 01 01 01 01 01 01 01 01 01 01 01 01 01 01 01 01 01 01 04 05