 61 62 62 62 62 62 62 62 62 62 62 62 62 62 62 62 62 62 62 62 62 62 62 63
 64 60 60 60 60 60 60 60 60 60 60 60 60 60 60 60 60 60 60 60 60 60 60 66
 64 60 60 60 60 60 60 60 60 60 60 60 60 60 60 60 60 60 60 60 60 60 60 66
 64 60 60 60 60 60 60 60 60 60 60 60 60 60 60 60 60 60 60 60 60 60 60 66
 64 60 60 60 60 60 60 60 60 60 60 60 60 60 74 75 75 75 76 60 60 60 60 66
 64 60 60 60 60 60 60 60 60 60 60 60 60 60 77 78 78 78 79 60 60 60 91 92
 64 60 60 60 60 60 60 60 60 60 60 60 60 60 60 60 60 60 60 60 60 60 94 95
 64 60 60 60 60 60 60 60 60 60 60 60 60 60 60 60 60 60 60 60 60 60 97 98
 64 60 60 60 60 60 60 60 60 60 60 60 60 60 60 60 60 60 60 60 60 60 60 66
 64 60 60 60 60 60 60 60 60 60 60 60 60 60 60 60 60 60 60 60 60 60 60 66
 64 60 60 60 60 60 60 60 60 60 60 60 60 60 60 60 60 60 60 60 60 60 60 66
 64 60 60 60 60 60 60 60 60 60 60 60 60 60 60 60 60 60 60 60 60 60 60 66
 64 60 60 60 60 60 60 60 60 60 60 60 60 60 60 60 60 60 60 60 60 60 60 66
 64 60 60 60 60 60 60 60 60 70 68 71 60 60 60 60 60 60 60 60 60 60 60 66
 92 93 60 60 60 60 60 60 60 66 65 64 60 60 60 60 60 60 60 60 60 60 60 66
 95 96 60 60 60 60 60 60 60 66 65 67 71 60 60 60 60 60 60 60 60 60 60 66
 98 99 60 60 60 60 60 60 60 73 62 63 64 60 60 60 60 60 60 60 60 60 60 66
 64 60 60 60 60 60 60 60 60 60 60 73 72 60 60 60 60 60 60 60 60 60 60 66
 64 60 60 60 60 60 60 60 60 60 60 60 60 60 60 60 60 60 60 60 60 60 60 66
 64 60 60 60 60 60 60 60 60 60 60 60 60 60 60 60 60 60 60 60 60 60 60 66
 64 60 60 60 60 60 60 60 60 60 60 60 60 60 60 60 60 60 60 60 60 60 60 66
 64 60 60 60 60 60 60 60 60 60 60 60 60 60 60 60 60 60 60 60 60 60 60 66
 64 60 60 60 60 60 60 60 60 60 60 60 60 60 60 60 60 60 60 60 60 60 60 66
 67 68 68 68 68 68 68 68 68 68 68 68 68 68 68 68 68 68 68 68 68 68 68 69