 01 01 01 01 01 01 01 01 01 01 01 01 01 01 01 01 01 01 01 01 01 01 01 01
 01 00 00 00 00 00 00 00 00 00 00 00 00 00 10 00 10 00 00 00 00 00 00 01
 01 00 00 00 00 00 00 10 00 10 00 00 00 00 00 10 00 00 00 00 00 00 00 01
 01 00 00 00 00 00 00 00 10 00 00 00 00 00 00 10 00 00 00 00 00 00 00 01
 01 00 00 00 00 00 00 00 10 00 00 00 00 00 10 10 10 00 00 00 00 00 00 01
 01 00 00 00 00 00 00 00 10 00 00 00 00 00 10 00 10 00 00 00 00 00 00 01
 01 00 00 00 00 00 00 10 00 10 00 10 10 00 10 00 10 00 00 00 00 00 00 01
 01 00 00 00 00 00 10 00 00 00 10 00 00 10 10 00 10 00 00 00 00 00 00 01
 01 00 00 00 00 00 00 10 00 10 00 10 10 00 10 10 10 00 00 00 00 00 00 01
 01 00 00 00 00 00 00 00 10 00 00 00 00 00 00 10 10 00 10 10 10 00 00 01
 01 00 00 10 10 10 10 00 10 00 00 00 00 00 00 10 10 00 10 00 10 00 00 01
 01 00 00 10 00 00 10 00 10 00 00 00 00 00 00 10 10 00 10 00 10 00 00 01
 01 00 00 10 00 00 10 00 10 00 00 00 00 00 10 10 10 00 10 00 10 00 00 01
 01 00 00 10 00 00 10 00 10 00 00 00 00 00 10 10 10 10 10 00 10 00 00 01
 01 00 00 10 10 10 10 10 10 00 00 00 00 00 10 10 10 10 10 10 10 00 00 01
 01 00 10 10 10 10 10 10 10 00 00 00 00 00 10 10 10 10 10 10 10 10 00 01
 01 00 00 00 00 00 00 00 00 00 00 00 00 00 00 00 00 00 00 00 00 00 00 01
 01 00 00 00 00 00 00 00 10 00 10 00 10 00 10 00 10 10 10 00 10 00 10 01
 01 00 00 00 00 00 00 00 10 00 10 00 10 10 10 00 10 00 10 00 10 00 10 01
 01 00 00 00 00 00 00 00 10 10 10 00 10 00 10 00 10 00 10 00 10 10 00 01
 01 00 00 00 00 00 00 00 00 00 10 00 10 00 10 00 10 10 10 00 10 00 10 01
 01 00 00 00 00 00 00 00 00 00 00 00 00 00 00 00 00 00 00 00 00 00 00 01
 01 00 91 92 93 00 91 92 93 00 00 00 00 00 00 00 00 91 92 93 91 92 93 01
 01 01 94 95 96 01 94 95 96 01 01 01 01 01 01 01 01 94 95 96 94 95 96 01
