 20 21 21 22 23 21 21 21 22 23 21 21 21 21 21 22 23 24 21 21 21 21 21 20
 21 20 20 20 20 20 20 20 20 20 20 20 20 20 20 20 20 20 20 20 20 20 20 21
 21 20 20 20 20 20 20 20 20 20 20 20 20 20 20 20 20 20 20 20 20 20 20 21
 21 20 20 20 20 20 21 21 20 20 20 20 20 20 20 21 21 20 20 20 20 20 20 21
 21 20 20 20 20 21 20 20 21 20 20 20 20 20 21 20 20 21 20 20 20 20 20 25
 21 20 20 20 20 21 20 20 21 20 20 20 20 20 21 20 20 21 20 20 20 20 20 26
 21 20 20 20 21 20 20 20 20 21 20 20 20 21 20 20 20 20 21 20 20 20 20 27
 21 20 20 20 21 20 20 32 21 21 22 23 21 21 21 32 20 20 21 20 20 20 20 21
 21 20 20 20 20 21 20 21 20 20 20 20 20 20 20 21 20 21 20 20 20 20 20 21
 25 20 20 20 20 20 21 20 20 30 20 20 20 30 20 20 21 20 20 20 20 20 20 21
 26 20 20 20 20 20 21 20 31 36 33 20 31 36 33 20 21 20 20 20 20 20 20 21
 27 20 20 20 21 21 21 20 20 34 20 20 20 34 20 20 21 21 21 20 20 20 20 21
 21 20 20 21 20 20 20 21 20 20 20 20 20 20 20 21 20 20 20 21 20 20 20 21
 21 20 20 25 20 20 20 20 21 20 20 30 20 20 21 20 20 20 20 21 20 20 20 21
 21 20 20 26 20 20 20 20 20 20 31 32 33 20 20 20 20 20 20 25 20 20 20 21
 21 20 20 27 20 20 20 20 20 20 20 20 20 20 20 20 20 20 20 26 20 20 20 21
 21 20 20 21 20 20 20 20 20 20 20 20 20 20 20 20 20 20 20 27 20 20 20 21
 21 20 20 20 21 20 20 20 20 20 20 20 20 20 20 20 20 20 21 20 20 20 20 25
 21 20 20 20 20 21 20 20 20 21 20 20 20 21 20 20 20 21 20 20 20 20 20 26
 21 20 20 20 20 20 21 21 21 20 20 20 20 20 21 21 21 20 20 20 20 20 20 27
 21 20 20 20 20 20 20 20 20 20 20 20 20 20 20 20 20 20 20 20 20 20 20 21
 21 20 20 20 20 20 20 20 20 20 20 20 20 20 20 20 20 20 20 20 20 20 20 21
 21 35 91 92 93 20 91 92 93 20 20 20 20 20 20 20 20 91 92 93 91 92 93 21
 20 21 94 95 96 21 94 95 96 21 21 21 21 21 21 21 21 94 95 96 94 95 96 21
