 02 03 01 01 01 01 01 01 01 01 01 01 01 01 01 01 01 01 01 01 01 01 01 01
 04 05 00 00 00 00 00 00 00 00 00 00 00 00 10 00 10 00 00 00 00 00 91 92
 01 00 00 00 00 00 00 10 00 10 00 00 00 00 00 10 00 00 00 00 00 00 94 95
 01 00 00 00 00 00 00 00 10 00 00 00 00 00 00 10 00 00 00 00 00 00 97 98
 01 00 00 00 00 00 00 00 10 00 00 00 00 00 10 10 10 00 00 00 00 00 00 01
 01 00 00 00 00 00 00 00 10 00 00 00 00 00 10 00 10 00 00 00 00 00 00 01
 01 00 00 00 00 00 00 10 00 10 00 10 10 00 10 00 10 00 00 00 00 00 00 01
 01 00 00 00 00 00 10 00 00 00 10 00 00 10 10 00 10 00 00 00 00 00 00 01
 01 00 00 00 00 00 00 10 00 10 00 10 10 00 10 10 10 00 00 00 00 00 00 01
 01 00 00 00 00 00 00 00 10 00 00 00 00 00 00 10 10 00 10 10 10 00 00 01
 01 00 00 10 10 10 10 00 10 00 00 00 00 00 00 10 10 00 10 00 10 00 00 01
 01 00 00 10 00 00 10 00 10 00 00 00 00 00 00 10 10 00 10 00 10 00 00 01
 01 00 00 10 00 00 10 00 10 00 00 00 00 00 10 10 10 00 10 00 10 00 00 01
 01 00 00 10 00 00 10 00 10 00 00 00 00 00 10 10 10 10 10 00 10 00 00 01
 01 00 00 10 10 10 10 10 10 00 00 00 00 00 10 10 10 10 10 10 10 00 00 01
 01 00 10 10 10 10 10 10 10 00 00 00 00 00 10 10 10 10 10 10 10 10 00 01
 01 00 00 00 00 01 00 01 00 00 01 00 01 00 00 01 00 00 01 00 01 00 00 01
 01 00 00 00 00 01 00 01 00 00 01 01 01 00 01 00 01 00 01 01 00 00 00 01
 01 00 00 00 00 01 00 01 00 00 01 00 01 00 01 00 01 00 01 01 00 00 00 01
 01 00 00 00 00 01 01 01 01 00 01 00 01 00 01 00 01 00 01 00 01 00 00 01
 92 93 00 00 00 00 00 00 01 00 01 00 01 00 00 01 00 00 01 00 01 00 00 01
 95 96 00 13 14 00 00 00 00 00 00 13 14 00 00 13 14 00 00 00 00 00 00 01
 98 99 11 12 00 00 13 14 00 11 12 00 00 00 00 11 12 00 00 00 13 14 02 03
 01 01 01 01 01 01 01 01 01 01 01 01 01 01 01 01 01 01 01 01 01 01 04 05
