 41 41 41 41 41 41 41 41 41 41 41 41 41 41 41 41 41 41 41 41 41 41 41 41
 41 40 40 40 40 40 40 40 40 40 40 40 40 40 40 40 40 40 40 40 40 40 40 41
 41 40 40 40 40 40 40 40 40 40 40 40 40 40 40 40 40 40 40 40 40 40 40 41
 41 40 40 40 40 40 40 40 40 40 40 40 40 40 40 40 40 40 40 40 40 40 40 41
 41 40 40 40 40 40 40 40 40 40 40 40 40 40 40 40 40 40 40 40 40 40 40 41
 42 43 40 40 40 40 40 40 40 40 40 40 40 40 40 40 40 40 40 40 40 40 42 43
 44 45 40 40 40 40 40 40 40 40 40 40 40 40 40 40 40 40 40 40 40 40 44 45
 41 40 40 40 40 40 40 40 40 40 40 40 40 40 40 40 40 40 40 40 40 40 40 41
 41 40 40 40 40 40 40 40 40 41 40 40 40 40 40 40 40 40 40 40 40 40 40 41
 41 40 40 40 40 40 40 41 41 40 40 40 40 40 40 40 40 40 40 40 40 40 40 41
 41 40 40 40 40 40 40 40 40 40 40 40 40 40 40 40 40 40 40 40 40 40 40 41
 41 40 40 40 40 40 41 40 40 40 40 40 40 40 40 40 40 40 40 40 40 40 40 41
 41 40 40 40 40 40 40 40 40 40 40 40 40 40 40 40 40 40 40 40 40 40 40 41
 41 40 40 40 40 40 40 40 40 40 40 40 40 40 40 40 40 40 40 40 40 40 40 41
 41 40 40 40 40 40 40 40 40 40 40 40 50 52 40 40 40 40 40 40 40 40 40 41
 41 40 40 40 40 40 40 40 40 40 40 40 53 51 40 40 40 40 40 40 40 40 40 41
 41 40 40 40 40 40 40 40 40 40 40 40 40 40 40 40 40 40 40 40 40 40 40 41
 41 40 40 40 40 40 40 40 40 40 40 40 40 40 40 40 40 42 43 40 40 40 40 41
 92 93 40 40 40 40 40 40 40 40 40 40 40 40 40 40 40 44 45 40 40 40 91 92
 95 96 40 40 40 40 40 40 40 54 55 40 40 40 40 40 40 40 40 40 40 40 94 95
 98 99 40 40 40 40 40 40 40 40 40 40 40 40 50 52 40 40 40 40 40 40 97 98
 41 40 40 40 40 40 40 40 40 40 40 40 40 40 53 51 40 40 40 40 40 40 40 41
 42 43 42 43 40 40 40 40 40 40 40 40 40 40 40 40 40 40 40 40 40 40 40 41
 44 45 44 45 41 41 41 41 41 41 41 41 41 41 41 41 41 41 41 41 41 41 41 41