 61 62 62 62 62 62 62 62 62 94 95 96 62 62 62 62 62 62 62 62 62 62 62 63
 64 60 60 60 60 60 60 60 60 97 98 99 60 60 60 60 60 60 60 60 60 60 60 66
 64 60 60 60 60 60 60 60 60 60 60 60 60 60 60 60 60 60 60 60 60 60 60 66
 64 60 60 60 60 60 60 60 60 60 60 60 60 60 60 60 60 60 60 60 60 60 60 66
 64 60 60 60 60 60 60 70 71 60 60 60 60 60 74 75 75 75 76 60 60 60 60 66
 64 60 60 60 60 60 60 66 67 68 68 68 68 71 77 78 78 78 79 60 60 60 60 66
 64 60 60 60 60 60 60 73 62 63 61 62 62 72 60 70 71 60 60 60 60 60 60 66
 64 60 60 60 60 60 60 60 60 73 72 60 60 60 60 73 72 60 70 68 68 68 68 69
 64 60 60 60 60 60 60 60 60 60 60 60 60 60 60 60 60 60 73 62 62 62 62 63
 64 60 60 60 60 60 60 60 60 60 60 60 60 60 60 60 60 60 60 60 60 60 60 66
 64 74 76 60 60 60 60 60 60 60 60 60 60 60 60 60 60 60 60 60 60 60 60 66
 64 77 79 60 60 60 60 60 60 60 60 60 60 60 60 60 60 60 60 60 60 60 60 66
 64 60 60 60 60 60 60 60 60 70 68 71 60 60 60 60 60 60 60 60 60 60 60 66
 64 60 60 60 60 60 60 60 60 66 65 64 60 60 60 60 60 60 60 60 60 60 60 66
 64 60 60 60 60 60 60 60 60 66 65 64 60 60 60 60 60 60 60 60 60 60 60 66
 64 60 60 60 60 60 60 60 60 66 65 64 60 60 60 60 60 60 60 60 60 60 60 66
 64 60 60 60 60 60 60 60 60 66 65 64 60 60 60 60 60 60 60 60 60 60 60 66
 64 60 60 60 60 60 60 60 60 66 65 67 68 71 60 60 60 60 60 60 60 60 60 66
 64 60 60 60 60 60 60 60 60 73 62 63 65 64 60 60 60 60 60 60 60 60 60 66
 64 60 60 60 60 60 60 60 60 60 60 73 62 72 60 60 60 60 60 74 75 75 76 66
 64 60 60 60 60 60 60 60 60 60 60 60 60 60 60 60 60 60 60 77 78 78 79 66
 67 68 68 71 60 60 60 60 60 60 60 60 60 60 60 60 60 60 60 60 60 60 60 66
 65 65 65 64 60 60 60 60 60 60 60 60 60 60 60 60 60 60 60 91 92 93 60 66
 63 65 65 67 68 68 68 68 68 68 68 68 68 68 68 68 68 68 68 94 95 96 68 69