 01 01 01 01 01 01 01 94 95 96 01 01 01 01 01 01 01 01 01 01 01 01 02 03
 01 00 00 00 00 00 00 97 98 99 00 00 00 00 00 00 00 00 00 00 00 00 04 05
 01 00 01 00 00 00 00 00 00 00 00 00 00 00 00 00 00 00 00 00 00 00 01 00
 01 10 00 00 00 01 00 00 00 00 00 00 00 00 00 00 00 00 00 00 00 00 01 00
 01 10 10 00 10 10 00 00 00 00 00 00 00 00 00 00 00 00 00 00 00 00 01 01
 01 00 10 00 10 00 00 00 00 00 00 00 00 00 00 00 00 00 00 00 00 00 00 01
 01 00 00 01 01 00 00 00 00 01 01 01 01 00 00 00 00 00 00 00 00 00 00 01
 01 00 10 02 03 00 00 00 01 00 00 00 00 01 00 00 00 00 00 00 00 00 00 01
 01 00 10 04 05 00 00 01 00 00 00 00 00 00 01 00 00 00 00 00 00 00 00 01
 01 00 10 00 00 10 01 00 00 00 00 00 00 00 00 01 00 00 00 00 00 00 00 01
 01 10 10 00 00 10 01 00 00 00 01 01 00 00 00 00 01 00 00 00 00 00 00 01
 01 10 00 00 00 01 00 00 00 01 00 00 01 00 00 00 01 00 00 00 00 00 00 01
 01 10 00 00 00 01 00 00 01 00 00 00 01 00 00 00 01 00 00 00 00 00 00 01
 01 10 00 00 00 01 00 00 01 00 01 00 01 00 00 00 01 00 00 00 00 00 00 01
 01 10 00 00 00 00 00 00 01 00 00 01 00 00 00 01 10 00 00 00 00 00 00 01
 01 10 00 00 00 00 00 01 00 00 00 00 00 00 01 00 00 10 00 00 00 00 00 01
 01 10 00 00 00 00 00 01 00 00 00 00 00 00 01 00 00 15 16 00 00 00 00 01
 01 10 00 00 00 00 00 00 01 01 00 00 01 01 00 00 15 16 15 16 00 00 00 01
 01 00 10 00 00 10 00 00 00 00 01 01 00 00 00 15 16 15 16 00 00 00 00 01
 01 00 00 11 12 00 13 14 15 16 11 12 13 14 10 00 00 00 00 00 00 00 00 01
 01 00 00 00 00 00 00 00 00 00 00 00 00 00 00 00 00 00 00 00 00 00 00 01
 01 00 00 00 00 00 00 00 00 00 00 00 00 00 00 00 00 00 00 00 00 00 00 01
 01 00 00 00 00 00 00 00 00 00 00 00 91 92 93 00 00 00 00 00 00 00 00 01
 01 01 01 01 01 01 01 01 01 01 01 01 94 95 96 01 01 01 01 01 01 01 01 01