BBBBBBBBBBBBBBBBBBBBBBBB
BAAAAAAAAAAAAAAAAAAAAAAB
BAAAAAAAAAAAAAAAAAAAAAAB
BAAAAAAAAAAAAAAAAAAAAAAB
BAAAAAAAAAAAAAAAAAAAAAAB
BAAAAAAAAAAAAAAAAAAAAAAB
BAAAAAAAAAAAAAAAAAAAAAAB
BAAAAAAAAAAAAAAAAAAAAAAB
BAAAAAAAAAAAAAAAABBBBBBB
BAAAAAAAAAAAAAAAAAAAAAAB
BAAAAAAAAAAAAAAAAAAAAAAB
BAAAAAAAAAAAAAAAAAAAAAAB
BAAAAAAAAAAAAAAAAAAAAAAB
BBBBBBBAAAAAAAAAAAAAAAAB
BAAAAAAAAAAAAAAAAAAAAAAB
BAAAAAAAAAAAAAAAAAAAAAAB
BAAAAAAAAAAAAAAAAAAAAAAB
BAAAAAAAAAAAAAAAAAAAAAAB
BAAAAAAAAAAAAAAAAAAAAAAB
BAAAAAAAAAAAAAAAAAAAAAAB
BAAAAAAAAAAAAAAAAAAAAAAB
BAAAAAAAAAAAAAAAAAAAAAAB
BAAAAAAAAAAAAAAAAAAAAAAB
BBBBBBBBBBBBBBBBBBBBBBBB