BBBBBBBBBBBBBBBBBBBBBBBB
BAAAAAAAAAAAAAAAAAAAAAAB
BAAAAAAAAAAAAAAAAAAAAAAB
BAAAAAAAAAAAAAAAAAAAAAAB
BAAAAAAAAAAAAAAAAAAAAAAB
BAAAAAAAAAAAAAAAAAAAAAAB
BAAAAAAAAAAAAAAAAAAAAAAB
BAAAAAAAAAAAAAAAAAAAAAAB
BAAAAAAAAAAAAAAAABBBBBBB
BAAAAAAAAAAAAAAAAAAAAAAB
BAAAAAAAAAAAAAAAAAAAAAAB
BAAAAAAAAAAAAAAAAAAAAAAB
BAAAAAAAAAAAAAAAAAAAAAAB
BAAAAAAAAAAAAAAAAAAAAAAB
BAAAAAAAAAAAAAAAAAAAAAAB
BAAAAAAAAAAAAAAAAAAAAAAB
BAAAAAAAAAAAAAAAAAAAAAAB
BAAAAAAAAAAAAAAAAAAAAAAB
BAAAAAAAAAAAAAAAAAAAAAAB
BAAAAAAAAAAAAAAAAAAAAAAB
BBBBBBBAAAAAAAAAAAAAAAAB
BBBAAAAAAAAAAAAAAAAAAAAB
BBBAAAAAAAAAAAAAAAAAAAAB
BBBBBBBBBBBBBBBBBBBBBBBB