 00 01 00 01 01 01 01 01 01 01 01 01 01 01 01 01 94 95 96 01 01 01 02 03
 00 00 00 00 01 00 00 00 00 00 00 10 00 00 00 00 97 98 99 00 00 00 04 05
 00 00 00 01 00 00 00 00 00 00 00 00 10 00 00 00 00 00 00 00 02 03 00 01
 00 00 01 00 00 00 00 00 00 00 00 00 00 00 00 00 00 00 02 03 04 05 00 01
 01 01 00 00 00 00 00 00 00 00 00 00 00 00 00 02 03 01 04 05 00 00 00 01
 01 00 00 00 00 00 00 00 00 00 00 00 00 00 01 04 05 00 00 00 00 00 00 01
 01 00 00 00 00 00 00 00 00 00 00 00 00 01 00 00 00 00 00 00 00 00 00 01
 01 00 00 00 00 00 00 00 00 00 00 00 00 00 00 00 00 00 00 00 00 00 00 01
 01 00 00 00 00 00 00 00 00 00 00 00 00 00 00 00 00 00 00 00 00 00 00 01
 01 01 00 00 00 00 00 00 00 00 01 01 01 00 00 00 00 00 00 00 00 00 00 01
 01 00 00 00 00 00 00 00 00 00 00 00 00 00 00 00 00 00 00 00 02 03 01 01
 01 00 00 00 10 00 00 00 00 00 00 00 00 00 00 00 00 00 00 00 04 05 00 00
 01 00 00 00 00 00 00 00 00 00 00 00 00 00 00 00 00 00 00 00 00 00 01 01
 01 00 00 00 00 00 00 00 00 00 00 13 14 00 00 00 00 00 00 00 00 00 00 01
 01 00 00 00 00 00 00 00 00 00 11 12 00 00 00 00 00 00 01 00 00 00 00 01
 01 00 00 00 00 00 00 00 00 00 00 00 00 00 00 00 00 01 00 00 00 00 00 01
 01 00 00 00 00 00 00 00 00 00 00 00 00 00 00 02 03 00 00 00 00 00 00 01
 01 00 00 00 00 00 00 00 00 00 00 00 00 01 01 04 05 00 00 00 00 00 00 01
 01 00 00 00 00 00 00 00 00 00 00 01 01 00 00 00 00 00 00 00 00 00 00 01
 01 00 00 00 00 00 00 00 00 00 01 00 00 00 00 00 15 16 00 00 00 00 00 01
 01 00 00 00 00 00 00 00 00 00 00 00 00 00 00 00 00 00 00 00 00 00 00 01
 01 00 00 00 00 00 00 00 00 00 00 00 01 00 00 00 01 00 00 00 00 00 00 01
 01 15 16 00 00 00 00 00 00 00 00 02 03 91 92 93 02 03 00 00 00 00 00 01
 01 01 01 01 01 01 01 01 01 01 01 04 05 94 95 96 04 05 01 01 01 01 01 01