 21 21 21 21 94 95 96 21 21 21 21 21 21 21 21 21 21 21 21 21 21 21 21 21
 21 20 20 20 97 98 99 20 20 20 20 20 20 20 20 20 20 20 20 20 20 20 20 21
 21 20 20 20 20 20 20 20 20 20 20 20 20 20 20 20 20 20 20 20 20 20 20 21
 21 20 20 20 20 20 20 20 20 20 20 20 20 20 20 20 20 20 20 20 20 20 20 21
 21 20 20 20 20 20 20 20 20 20 20 20 20 20 20 20 20 20 20 20 20 20 20 21
 21 20 20 20 20 20 20 20 20 20 20 20 20 20 20 20 20 20 20 20 20 20 20 21
 21 20 20 20 20 20 20 20 20 20 20 20 20 20 20 20 20 20 20 20 20 20 20 21
 21 20 20 20 21 21 21 22 23 24 20 20 20 20 20 20 20 20 20 20 20 20 20 25
 21 20 20 20 20 20 22 23 24 25 20 20 20 20 20 20 20 20 20 20 20 20 25 26
 21 20 20 20 20 20 20 20 20 26 20 20 20 20 20 20 20 20 20 20 20 20 26 27
 21 20 20 20 20 20 20 20 20 27 20 20 20 20 20 20 20 20 20 20 20 20 27 21
 22 23 24 20 20 20 20 20 20 20 20 20 20 20 20 20 20 20 20 20 20 20 20 21
 23 20 20 20 20 20 20 20 20 20 20 20 20 20 30 20 20 20 20 20 20 20 20 21
 24 20 20 20 20 20 20 20 20 20 20 20 20 31 32 33 20 20 20 20 20 20 20 21
 21 20 20 20 20 20 20 20 20 20 20 20 20 31 32 33 20 20 20 20 20 20 20 21
 21 20 20 20 20 20 20 20 20 20 20 20 20 31 32 33 20 20 20 20 20 20 20 21
 21 20 20 20 20 20 20 20 20 20 20 20 20 20 34 20 20 20 20 20 20 20 20 21
 21 20 20 20 20 20 20 20 20 20 20 20 20 20 20 20 20 20 20 20 20 20 20 21
 21 20 20 20 20 20 20 20 20 20 20 20 20 20 20 20 20 20 20 20 20 20 20 21
 21 20 20 20 20 20 20 20 20 20 20 20 20 20 20 20 20 20 20 20 20 20 20 21
 25 20 20 20 20 20 20 20 20 20 20 20 20 20 20 20 20 20 20 20 20 20 20 21
 26 20 20 20 20 20 20 20 20 20 20 20 20 20 20 20 20 20 20 20 20 20 20 21
 27 20 20 91 92 93 20 20 20 20 20 20 20 20 20 20 20 20 20 20 20 20 20 21
 22 23 24 94 95 96 21 21 21 21 21 21 21 21 21 21 21 21 21 21 21 21 21 21