 40 40 41 41 41 41 41 94 95 96 41 41 41 41 41 41 41 41 41 41 41 41 54 55
 40 41 40 40 40 40 40 97 98 99 40 40 40 40 40 40 40 40 40 40 40 40 41 40
 41 40 40 40 40 40 40 40 40 40 40 40 40 40 40 40 40 40 40 40 40 40 40 41
 41 40 40 40 40 40 40 40 40 40 40 40 40 40 40 40 40 40 40 40 40 40 40 41
 41 40 40 41 41 42 43 40 40 40 40 40 42 43 41 41 41 40 40 40 40 40 40 41
 41 40 41 40 40 44 45 40 40 40 40 40 44 45 40 40 40 41 40 40 40 40 40 41
 55 41 40 40 40 40 40 41 40 40 40 41 40 40 40 40 40 40 41 40 40 40 40 41
 41 40 40 40 40 40 40 40 41 40 41 40 40 40 40 40 40 40 40 41 40 40 40 41
 41 40 40 40 40 40 40 40 41 40 41 40 40 40 40 40 40 40 40 41 40 40 40 41
 41 40 40 40 40 40 40 40 40 41 40 40 40 40 40 40 40 40 40 41 40 40 40 41
 41 40 40 40 40 40 40 40 40 40 40 40 40 40 40 40 40 40 40 41 40 40 40 41
 42 43 40 40 40 40 40 40 40 40 40 40 40 40 40 40 40 40 41 52 40 40 40 41
 44 45 40 40 40 40 40 40 40 40 40 40 40 40 40 40 40 40 41 40 40 40 40 41
 41 51 41 40 40 40 40 40 40 40 40 40 40 40 40 40 40 41 51 40 40 40 40 41
 41 40 50 40 40 40 40 40 40 40 40 40 40 40 40 40 40 41 40 40 40 40 40 41
 41 40 53 51 40 40 40 40 40 40 40 40 40 40 40 40 41 50 40 40 40 40 40 41
 41 40 40 41 40 40 40 40 40 40 40 40 40 40 40 40 41 40 40 40 40 40 40 41
 41 40 40 40 52 40 40 40 40 40 40 40 40 40 40 41 40 40 40 40 40 40 40 41
 92 93 40 40 40 53 40 40 40 40 40 40 40 40 41 40 40 40 40 40 40 40 42 43
 95 96 40 40 40 40 52 40 40 40 40 40 40 41 40 40 40 40 40 40 40 40 44 45
 98 99 40 40 40 40 40 51 40 40 40 40 41 40 40 40 40 40 40 40 40 40 91 92
 42 43 40 40 40 40 40 40 50 40 40 41 40 40 40 40 40 40 40 40 40 40 94 95
 44 45 42 43 91 92 93 40 40 42 43 40 40 40 40 40 40 40 40 40 40 40 97 98
 40 40 44 45 94 95 96 41 41 44 45 41 41 41 41 41 41 41 41 41 41 41 41 41