 41 41 41 41 41 41 41 41 94 95 96 41 41 41 41 41 41 41 41 41 41 41 41 41
 41 40 40 40 40 40 40 40 97 98 99 40 40 40 40 40 40 40 40 40 40 40 40 41
 41 40 40 40 40 40 40 40 40 40 40 40 40 40 40 40 40 40 40 40 40 40 40 41
 41 40 40 40 40 40 40 40 40 40 40 40 40 40 40 40 40 40 40 40 40 40 40 41
 41 40 40 40 40 40 40 40 40 40 40 40 40 40 40 40 40 40 40 40 40 40 40 41
 41 40 40 40 41 41 40 40 41 40 40 41 40 41 40 41 40 40 41 40 40 40 40 41
 41 40 40 41 40 40 40 41 40 41 40 41 40 41 40 41 40 41 40 41 40 40 40 41
 41 40 40 41 40 40 40 41 41 41 40 41 40 41 40 41 40 41 41 41 40 40 40 41
 41 40 40 41 40 40 40 41 40 41 40 41 40 41 40 41 40 41 40 41 40 40 40 41
 41 40 40 40 41 41 40 41 40 41 40 41 41 41 41 41 40 41 40 41 40 40 40 41
 41 40 40 40 40 40 40 40 40 40 40 40 40 40 40 40 40 40 40 40 40 40 40 41
 41 40 40 40 40 40 40 40 40 40 40 40 40 40 40 40 40 40 40 40 40 40 40 41
 41 40 40 40 40 40 40 40 40 40 40 40 40 40 40 40 40 50 40 40 50 40 40 41
 41 40 40 42 43 40 40 40 40 40 40 40 40 40 40 40 50 50 50 50 50 50 40 41
 41 40 40 44 45 40 40 40 40 40 40 40 40 40 40 40 50 40 40 40 40 50 40 41
 41 42 43 40 40 42 43 40 40 40 40 40 40 40 40 50 40 40 40 40 40 40 50 41
 41 44 45 40 40 44 45 40 40 40 40 40 40 40 40 50 40 54 55 54 55 40 50 41
 41 40 40 42 43 40 40 40 40 40 40 40 40 40 40 50 40 40 40 40 40 40 50 41
 41 40 40 44 45 40 40 40 40 40 40 40 40 40 40 40 50 40 40 40 40 50 40 41
 41 40 40 40 40 40 40 40 40 40 40 40 40 40 40 40 40 50 50 50 50 40 40 41
 41 40 40 40 40 40 40 40 40 40 40 40 40 40 40 40 40 40 40 40 40 40 40 41
 41 40 40 40 40 40 40 40 40 40 40 40 40 40 40 40 40 40 40 40 40 40 40 41
 41 40 40 40 40 40 40 40 40 40 40 40 40 91 92 93 40 40 40 40 40 40 40 41
 41 41 41 41 41 41 41 41 41 41 41 41 41 94 95 96 41 41 41 41 41 41 41 41