 25 21 21 21 21 22 23 24 94 95 96 21 21 21 22 23 24 21 22 23 24 21 21 21
 26 35 35 35 35 35 35 35 97 98 99 35 35 35 35 35 35 35 35 35 35 35 35 21
 27 35 35 35 35 35 35 35 35 35 35 35 35 35 35 35 35 35 35 35 35 35 35 21
 21 35 35 35 21 35 21 35 21 21 21 35 35 35 21 35 35 21 35 21 35 35 35 21
 21 35 35 35 21 35 35 35 21 35 35 35 35 21 35 21 35 21 21 35 35 35 35 25
 21 35 35 21 21 35 21 35 21 21 21 35 35 21 35 21 35 21 35 35 35 35 35 26
 21 35 21 35 21 35 21 35 21 35 35 35 35 21 35 21 35 21 35 35 35 35 35 27
 25 35 21 21 21 35 21 35 21 21 21 35 35 35 21 35 35 21 35 35 35 35 35 21
 26 35 35 35 35 35 35 35 35 35 35 35 35 35 35 35 35 35 35 35 35 35 35 21
 27 35 35 35 35 35 35 35 35 35 35 35 35 35 35 35 35 35 35 35 35 35 35 21
 21 20 20 20 20 20 20 35 35 35 35 21 35 35 35 21 35 21 35 21 35 35 35 21
 21 20 20 36 36 20 20 35 35 35 35 21 35 35 35 21 35 35 35 21 21 35 35 25
 21 20 20 36 20 36 20 35 35 35 35 21 35 35 35 21 35 21 35 21 35 21 35 26
 21 20 20 36 20 36 20 35 35 35 35 21 35 21 35 21 35 21 35 21 35 21 35 27
 21 20 20 36 20 36 20 35 35 35 35 35 21 35 21 35 35 21 35 21 35 21 35 21
 21 20 20 36 36 20 20 35 35 35 35 35 35 35 35 35 35 35 35 35 35 35 35 21
 25 20 20 20 20 20 20 20 20 20 20 20 20 20 20 20 20 20 20 20 20 20 20 21
 26 20 36 36 36 20 36 36 36 20 36 36 20 20 20 36 20 20 36 20 36 36 20 21
 27 20 36 20 20 20 36 20 20 20 36 20 36 20 36 20 36 20 20 20 36 20 36 21
 21 20 36 36 36 20 36 36 36 20 36 36 20 20 36 20 36 20 36 20 36 36 20 21
 25 20 36 20 20 20 20 20 36 20 36 20 20 20 36 36 36 20 36 20 36 20 36 21
 26 20 36 36 36 20 36 36 36 20 36 20 20 20 36 20 36 20 36 20 36 20 36 21
 27 20 20 20 20 20 20 20 20 20 20 20 20 91 92 93 20 20 20 20 20 20 20 21
 21 21 22 23 24 22 23 24 21 21 21 22 23 94 95 96 21 21 21 21 21 22 23 24
