 41 41 41 41 41 41 41 41 94 95 96 41 41 41 41 41 41 41 41 41 41 41 41 41
 41 40 40 40 40 40 40 40 97 98 99 40 40 40 40 40 40 40 40 40 40 40 40 41
 41 40 54 55 40 40 40 41 40 40 40 40 40 40 40 40 40 40 40 40 40 40 40 41
 41 40 40 40 40 40 40 40 41 40 40 40 40 40 40 40 40 40 40 40 40 40 40 41
 41 40 40 40 40 40 40 40 42 43 40 40 40 40 40 40 40 40 40 40 40 40 40 41
 41 40 40 40 40 40 40 40 44 45 42 43 40 40 40 40 40 40 40 40 40 40 40 41
 41 40 40 40 40 40 40 40 40 40 44 45 41 40 40 40 40 40 40 40 40 40 40 41
 41 40 40 40 40 40 40 40 40 40 40 40 40 42 43 40 40 40 40 40 54 55 40 41
 41 40 40 40 40 40 40 40 40 40 40 40 40 44 45 41 41 40 40 40 40 40 41 41
 41 40 40 40 40 40 41 40 40 40 40 40 40 40 40 40 40 40 40 40 40 40 40 41
 41 40 40 40 50 51 40 40 40 40 40 40 40 40 40 40 40 40 40 40 40 40 40 41
 41 40 40 40 40 40 40 40 40 40 40 40 40 40 40 40 40 40 40 40 40 40 40 41
 41 40 40 40 40 40 40 40 40 40 40 40 40 40 40 40 40 40 40 40 40 40 40 41
 41 40 40 40 40 40 40 40 40 40 40 40 40 40 40 40 40 40 40 40 40 40 40 41
 41 40 40 40 40 40 40 40 40 40 40 40 40 40 40 40 40 40 40 40 40 40 41 41
 41 40 40 40 40 40 40 40 40 40 40 40 40 40 40 40 40 40 40 40 40 40 40 41
 41 40 40 40 40 40 40 40 40 40 40 40 40 40 40 40 40 40 40 40 40 40 40 41
 41 40 40 40 40 52 53 40 40 40 40 40 40 40 40 40 40 40 40 40 40 40 40 41
 41 40 40 40 40 40 50 51 40 40 40 40 40 40 40 40 40 40 40 40 40 40 40 41
 41 41 40 40 40 40 40 40 41 40 40 40 40 40 40 40 40 40 54 55 40 40 40 41
 42 43 40 40 40 40 40 40 40 41 40 40 40 40 40 40 40 40 40 40 40 40 40 41
 44 45 40 40 40 40 40 40 40 40 41 40 40 40 40 40 40 40 40 40 40 40 40 41
 42 43 42 43 91 92 93 40 40 40 41 41 41 40 40 40 40 40 40 40 40 40 41 40
 44 45 44 45 94 95 96 41 41 41 41 40 40 41 41 41 41 41 41 41 41 41 41 40